pronouns	
je	ʒə
tu	tu
il	il
elle	ɛl
nous	nu
vous	vu
ils	il
elles	ɛl
ce	sə
cet	sɛt
cette	sɛt
ces	sɛ

articles	
le	lə
la	la
les	le
un, uns 	œ̃
une, unes	yn
des	de

ne	nə
pas	pa

que	kə
quel( f quelle, mpl quels, fpl quelles ) 	[kɛl] 

mon, ma, mes	notre, notre, nos [nɔtr, nɔ]
ton, ta, tes	votre, votr, vos [vɔtr; vo]
le, la, les	leur, leur, leurs

voir	see
avoir	
voulvoir	want
devoir	must
pouvoir	be able to

être	ɛtr
suis	
es	
est	et
sommes	
êtes	
sont	

Урок 1
gauche	goʃ
droit, droite	drwa, drwat
à	a
pardon	pardɔ̃
pont	pɔ̃
métro	metro
où	u
oui	wi
non	nɔ̃
là-bas	laba
voilà	vwala
voici 	vwasi
fontaine	fɔ̃tɛn
attendez	atɑ̃de
au	o
plaît	plɛ
minute	minyt
boulevard	bulvar
mais	mɛ
bien	bjɛ̃
sûr, sûre	syr
joli, jolie	ʒɔli
alors	alɔr
aussi	osi
touriste	turist

Урок 2
magasin	magazɛ̃	
accord	akɔr	
Madame	madam	
cher, chère	ʃɛr	
chapeau	ʃapo	
prix	pri	
très	trɛ	rather
raisonnable	rɛzɔnabl]	
bon,  bonne	bɔ̃, bɔn	
gant	gɑ̃	
merci	mɛrsi	
en	ɑ̃	
laine	lɛn	
cinq	sɛ̃k	
heur	ɶr	
comment	kɔmɑ	what
comprends	kɔ̃prɑ̃	
ça	sa	
mari	mari	
pleuvoir	[pløvwar] 	rain
dehors	[dəɔr] 	outside
heure	[ɶr] 	

Урок 3
désirez	dezire	
deux	dø	
café	[kafe] 	
croissant	[krwasɑ̃] 	
bien	[bjɛ̃] 	well
Monsieur, Messieurs	[məsjø] (pl  [mesjø] ) 	
chaud, (     f chaude )	 [ʃo, ʃod] 	warm, hot, ardent
anglais, (     f anglaise 	[ɑ̃glɛ, ɛz] 	
français, ( f française )  	[frɑ̃sɛ, ɛz]	
 allemand, allemande 	 [almɑ̃, ɑ̃d] 	
Londres	[lɔ̃dr] 	
gentil (gentille ) 	[ʒɑ̃ti, ij] 	nice, kind
tout	tu, tus	
autre	[otr] 	other, different
beurré,( f beurrée )	 [bɶre] 	bread and butter
excuser	[ɛkskyze] 	
dépêcher	[depeʃe] 	send, hurry up
toujours	[tuʒur] 	always
hollandais( f hollandaise ) 	[ʼɔlɑ̃dɛ, ɛz] 	dutch

trois	[trwa] 	three
verre	[vɛr] 	glass
bière	[bjɛr] 	beer
vin	[vɛ̃] 	
allemand (allemande )	 [almɑ̃, ɑ̃d] 	german
blanc(blanche)	 [blɑ̃, blɑ̃ʃ] 	
bleu (bleue)	 [blø] 	
noir (noire)	 [nwar] 	
feu	 [fø	fire
dans	[dɑ̃]	in
rue	[ry] 	street
fumer	[fyme] 	to smoke
désolé ( f désolée ) 	[dezɔle] 	sorry
briquet	[brikɛ] 	lighter
paquet	[pakɛ] 	pack
rond(     f ronde ) 	[rɔ̃, rɔ̃d] 	round
haut, haute	o, ot	tall
court	kur	short
intelligent	[ɛ̃teliʒɑ̃, ɑ̃t] 	clever
arbre	arbr	tree
voiture	vwatyr	car
vert	 [vɛr, vɛrt] 	green
livre	livr	book
table	tabl	

conversation	[kɔ̃vɛrsasjɔ̃] 	
téléphonique	[telefɔnik] 	phone
absent ( absente)	 [apsɑ̃, ɑ̃t] 	absent
pour	pur	for
moment	[mɔmɑ̃] 	moment
après	[aprɛ] 	next
midi	[midi] 	noon
beaucoup	boku	a lot
rien	[rjɛ̃]	nothing
mademoiselle	[madmwazɛl] 	
fait	[fɛ] 	act, deed
idée	[ide] 	
aimer	[eme] 	like, love
fair	[fɛr] 	do
romantique	[rɔmɑ̃tik] 	
drôle	[drol] 	funny
hirondell		swallow

Урок 8
maison	[mɛzɔ̃] 	house
avant	[avɑ̃] 	before
bureau	 [byro] 	office
déranger	[derɑ̃ʒe] 	disturb
normalement	[nɔrmalmɑ̃] 	normally
rentrer	[rɑ̃tre] 	come home
mère		mother
chercher	ʃɛrʃe	search

achat	aʃa	buying
fromage		cheese
aujourd'hui		today
chaque		every
année	ane	year
beurre	[bɶr] 	butter
bière	[bjɛr] 	beer
donner		give
plaquette		pack

Урок 9
appeler	aple	call out
fils	fis	son
nouveau; nouvelle	nuvel	new
âge		age
an		year
habiter	abite	live in
chez		with
évidemment		evidently
demander	[dəmɑ̃de] 	ask for
travail;  travaux	travaj,o	work
naissance	[nɛsɑ̃s] 	birth
même	[mɛm] 	even
régler	[regle] 	pay for
oublier	[ublije] 	forget
portefeuille	[pɔrtəfɶj] 	billford

Урок 10
d'habitude	dabityd	usually
acheter	[aʃte] 	to buy
manger	[mɑ̃ʒe] 	to eat
supermarché	s	
monter	[mɔ̃te] 	go up
d'abord	dabɔr]	at first
paisible	[pezibl] 	quiet
tôt	to	early
tard	tar	late
puis	[pɥi] 	then
mettre	[mɛtr] 	switch on
dîner	dine	to have dinner
écouter	[ekute] 	listen to
malgré	[malgre] 	despite
disponible	dispɔnible	available
tranquille	 [trɑ̃kil] 	caln
passer	pase	go by
soirée	[sware] 	evening
calme	kalm	quiet
quelque	[kɛlk(ə)] 	some
parce que	parskə	beacause

Урок 11
et demie	dəmi	and a half
pendant		during
inutile	inytil	useless
lire	lir	read
metteur en scéne		editor
connaître		know
jeune	ʒɶn	young
vieax; vieille		old
mâcher	maʃe	chew
dîter		say
complètement		completely
interéssant		

Урок 12
église		church
terminer		finish
important	[ɛ̃pɔrtɑ̃, ɑ̃t] 	
laisser		leave

Урок 13
chanteur,   chanteuse	[ʃɑ̃tɶr, øz] 	singer
voix	[vwa] 	voice
idiot( f idiote )  	[idjo, ɔt]	stupid
bête	[bɛt] 	stupid
triste	[trist] 	sad
seulement	 seulement 	only
pas de tout		not at all
dessous	[d(ə)su] 	underneath
ajouter	[aʒute] 	to add
mort( f morte )	 [mɔr, mɔrt] 	dead
vif (f vive ) 	[vif, viv] 	lively

Урок 15
garder	[garde] 	to look after; to guard
téléphoner	 [telefɔne] 	to make a call
matin	[matɛ̃] 	morning
vendre	 [vɑ̃dr] 	to sell
canapé	 [kanape] 	sofa
fauteuil	[fotɶj] 	chair
cuir	[kɥir] 	skin
louer	lwa	to rent
salle	[sal] 	room
meuble	[mɶbl] 	a piece of furniture
sujet	suje	topic; subject
anonce		
demain	[dəmɛ̃] 	tommorrow
dernier (f dernière) 	[dɛrnje, dɛrnjɛr] 	last; final

Урок 16
le piége		
le rat; la rate	ra	rat
avion		
le modèle		
douanier		
douane		
sac		
diamant		
lapin		
parfaitement		
apporter	[apɔrte] 	to bring

Урок 38
posséder		possess
tradition		tradition
cinématographique		
apprécier		appreciate
énorme		huge
policier		
dessin animé		
nouveauté		f; novelty
naturellement		naturally
étranger, étrangére		foreign; stranger
c'est-à-dire		so called
s'imposer		be held
remise		f, delivery
attribuer		to award
décontracter		to relax
gagnant(e)		winner
émouvoir		to touch; to disturb
surprendre		to surprise




