택배 = delivery
택배로 보내다 = to send something via delivery
택배가 언제 올지 모르겠어요 = I don’t know when the delivery will come
장모님께 선물을 직접 드리고 싶었는데 우리가 만나지 못하기 때문에 택배로 보내야겠어요 = I wanted to give my mother in law a present in person, but we didn’t meet, so I have to mail it to her

가격 = price
가격표 = price tag
가격을 내리다/인하하다 = to lower prices
가격을 올리다/인상하다 = to raise prices
가격을 깎다 = to cut prices
가격을 비교하다 = to compare prices
가격을 확인해보자 = Let’s check the price
이 뷔페가격은 음료수를 포함한 가격이에요 = This buffet price includes drinks
이 셔츠에 가격표가 없기 때문에 얼마인지 몰라요 = I don’t know how much this shirt is because there is no price tag

용돈 = allowance

아르바이트 = part-time job

빛 = a light

시인 = poet

주제 = subject

그룹 = group

요금 = fare, price

위치 = position, location

해안 = the coast

가정 = family

재료 = materials, ingredients

자유 = freedom

책임 = responsibility

입구 = entrance, way in

출구 = exit , way out

출입 = enter and exit

수술 = surgery, operation

훈련 = training

비상 = emergency

계단 = steps, stairs, staircase

전통 = tradition, culture, heritage

호선 = a subway line

기간 = a period of time

구체적 = detailed, specific

저는 친구가 어디 가는지 몰라요 = I don’t know where my friend is going
저는 친구가 어디 가는지 모르겠어요 = I don’t know where my friend is going
엄마가 누구랑 먹는지 모르겠어요 = I don’t know who mom is eating with
엄마가 뭐 먹는지 모르겠어요= I don’t know what mom is eating
엄마가 어디서 먹는지 모르겠어요 = I don’t know where mom is eating
엄마가 왜 먹는지 모르겠어요 = I don’t know why mom is eating
엄마가 지금 먹고 있는지 모르겠어요 = I don’t know if mom is eating now

그 사람을 왜 데려오는지 물어봤어요 = I asked him why he is bringing that person
비상출입구가 어디 있는지 찾았어요 = We found where the emergency exit is
해안까지 어떻게 가는지 물어봤어요 = I asked how to get to the beach/coast
엄마가 무슨 재료를 쓰고 있는지 모르겠어요 = I don’t know what ingredients mom is using
정부가 외국인 선생님 예산을 왜 줄이는지 모르겠어요 = I don’t know why the government is decreasing the budget for foreign teachers
학생들은 선생님들이 돈을 얼마나 버는지 몰라요 = Students don’t know how much money teachers earn
저는 그 학생이 어느 대학교를 다니는지 기억(이) 안 나요 = I don’t remember which university that student attends

저는 엄마가 왜 먹었는지 모르겠어요 = I don’t know why mom ate
저는 엄마가 뭐 먹었는지 모르겠어요 = I don’t know what mom ate
저는 엄마가 언제 먹었는지 모르겠어요 = I don’t know when mom ate
저는 엄마가 어디서 먹었는지 모르겠어요 = I don’t know where mom ate
저는 엄마가 밥을 먹었는지 모르겠어요 = I don’t know if mom ate

그 셔츠를 언제 버렸는지 기억이 안 나요 = I don’t remember when I threw away that shirt
Play열쇠를 어디 두었는지 잊어버렸어요 = I forget where I put my keys
Play우리가 이것을 언제 정했는지 모르겠어요 = I don’t know when we set it
Play그가 저에게 무슨 말을 전했는지 기억이 안 나요 = I don’t remember what that person told me (conveyed to me)

택배가 언제 올지 모르겠어요 = I don’t know when the delivery will come
Play용돈을 얼마나 줄지 모르겠어요 = I don’t know how much allowance I should give
Play오후에 비가 올지 모르겠어요 = I don’t know if it will rain in the afternoon
Play수술을 받을지 확실하지 않아요 = It is not certain if I will get surgery
Play내일 공원에 갈지 모르겠어요 = I don’t know if I will go to the park tomorrow
Play내일 영화를 볼지 모르겠어요 = I don’t know if I will see a movie tomorrow

오후에 비가 올지 모르겠어요 = It might rain in the afternoon tomorrow
Play수술을 받을지 모르겠어요 = I might get surgery
Play내일 공원에 갈지 모르겠어요 = I might go to the park tomorrow
Play내일 영화를 볼지 모르겠어요 = I might see a movie tomorrow

제가 준 것이 괜찮은지 모르겠어요 = I don’t know if the thing that I gave is good
Play이 빛이 충분히 밝은지 모르겠어요 = I don’t know if this light is bright enough
Play제가 구한 아르바이트가 좋은지 모르겠어요 = I don’t know if the job I found is good
Play제가 가져온 자료가 충분한지 모르겠어요 = I don’t know if I brought enough materials
Play제가 강아지를 기르고 싶은지 모르겠어요 = I don’t know if I want to raise a puppy
Play그 책이 얼마나 긴지 모르겠어요 = I don’t know how long that book is

그 시대가 그렇게 길었는지 깨닫지 못했어요 = I didn’t realize that era was so long
Play그 일이 힘들지 모르겠어요 = I don’t know if that work will be difficult
Play내일 날씨가 쌀쌀할지 모르겠어요 = I don’t know if tomorrow’s weather will be chilly

내일 영화를 볼지 안 볼지 모르겠어요 = I don’t know if I will see a movie tomorrow or not
Play수술을 받을지 안 받을지 확실하지 않아요 = It is not certain if I will get surgery or not
Play그가 제 말을 들었는지 안 들었는지 모르겠어요 = I don’t know if he was listening to me or not
Play저는 엄마가 밥을 먹었는지 안 먹었는지 모르겠어요 = I don’t know if mom ate or not
Play제가 구한 아르바이트가 좋은지 안 좋은지 모르겠어요 = I don’t know if the job I found is good or not

저는 엄마가 공부했는지 안 했는지 모르겠어요 = I don’t know if mom studied or not

Play내일 공원에 갈지 영화를 볼지 모르겠어요 = I don’t know if I will see a movie or go to the park tomorrow

Play제가 구한 아르바이트가 좋은지 나쁜지 모르겠어요 = I don’t know if the (part-time) job I found is good or bad

Play수술을 받을지 그냥 약으로 치료할지 확실하지 않아요 = It is not certain if I will get surgery or just treat it with medicine

서울에 어떻게 가는지 알아요? = Do you know how to get to Seoul?
Play그 단어를 어떻게 발음하는지 알아요? = Do you know how to pronounce that word?
Play그 학생이 책을 왜 버렸는지 알아요? = Do you know why that student threw out his book?
Play물을 어떻게 막는지 알아요? = Do you know how to block the water?

서울에 어떻게 가는지 알아요 = I know how to get to Seoul
Play그 단어를 어떻게 발음하는지 알아요 = I know how to pronounce that word
Play그 학생이 책을 왜 버렸는지 알아요 = I know why that student threw out his book

내일 비가 올지 모르겠어요 = It might rain tomorrow
Play내일 비가 올지도 모르겠어요 = It might rain tomorrow

내일 공원에 갈지 모르겠어요 = I might go to the park tomorrow
Play내일 공원에 갈지도 모르겠어요 = I might go to the park tomorrow

저는 친구가 어디 가는지 모르겠어요 = I don’t know where my friend is going

밥을 먹은 지 5분 됐다 = It has been five minutes since I last ate
한국에서 산 지 25년 됐어요 = I have been living in Korea for 25 years
강아지를 기른 지 10년 됐어요 = I have been raising a dog for 10 years
그 그룹이 훈련을 받은 지 다섯 시간 됐어요 = That group has been receiving training for 5 hours
이 아르바이트를 한 지 2 주일 됐어요 = I’ve had this part-time job for 2 weeks
한국에 온 지 2년 됐어요 = I have been in Korea for 2 years
여자 친구랑 헤어진 지 6개월 됐어 = It has been six months since I broke up with my girlfriend
이제 결혼한 지 1년 됐어요 = I have been married for one year
운동한 지 한 시간 됐어요 = I have been exercising for one hour
샤워한 지 10분 됐어요 = I have been showering for 10 minutes
고등학교를 졸업한 지 1년 됐어요 = I graduated one year ago

우리가 안 만난 지 2주일 됐어요 = We haven’t met in 2 weeks
밥을 안 먹은 지 아홉 시간 됐어요 = I haven’t eaten in nine hours
용돈을 안 받은 지 1년 됐어요 = I haven’t received (an) allowance in a year
한국어를 공부한 지 얼마나 되었어요? = How long have you been studying Korean?
운동한 지 오래 됐어? = Have you been exercising for a long time?
제가 한국에서 산 지 얼마 안 됐어요 = I haven’t been living in Korea for very long
제가 우리 학교에서 일한 지 얼마 안 됐어요 = I haven’t been working at our school for very long